000000000
001000000
010000000
111111111
111111111
111111111
111111111
111111111
001000010
010000100
011000000
100000000
101000000
110000000
111000000
111111111
010000110
011000100
100001000
101010000
111111111
111111111
111111111
111111111
111111111
111111111
111111111
111111111
111111111
111111111
111111111
111111111
